cerca - to search
potrebbe - could
sgravio - relief
capo sanitario - health chief
alcuni - some
faccenda - matter
già - already
sintetizzare - synthesize
che in precedenza - that previously 
degli - from
possono - can
l'insorgenza - the occurence
riconoscimento - recognition 
erano - were
sparsi - scattered
decine di migliaia - tens of thousands
settore - sector
di grandi - large
come anche - as well as
nate dalle - born from
migliori - best
non è passata inosservata - has not gone unnoticed
Non è un caso che - It is no coincidence that 
abbia - has
ospitato - hosted 
riguardano - concern
avvertono - warn
ostacoli - obstacles
stanno - they are
frenando - stopping
paese -  country
inerenti - inherent
ad un - to a
aziendale - corporate
